### #
##  #
#  ##
## ##
## ##
